# Copyright (c) 2003-2011, CKSource - Frederico Knabben. All rights reserved.
# For licensing, see LICENSE.html or http://ckeditor.com/license

euro = Tooltip for the Euro sign special character.
lsquo = Tooltip for the left single quotation mark special character.
rsquo = Tooltip for the right single quotation mark special character.
ldquo = Tooltip for the left double quotation mark special character.
rdquo = Tooltip for the right double quotation mark special character.
ndash = Tooltip for the en dash special character.
mdash = Tooltip for the em dash special character.
iexcl = Tooltip for the inverted exclamation mark special character.
cent = Tooltip for the cent sign special character.
pound = Tooltip for the pound sign special character.
curren = Tooltip for the currency sign special character.
yen = Tooltip for the yen sign special character.
brvbar = Tooltip for the broken bar special character.
sect = Tooltip for the section sign special character.
uml = Tooltip for the diaeresis special character.
copy = Tooltip for the copyright sign special character.
ordf = Tooltip for the feminine ordinal indicator special character.
laquo = Tooltip for the left-pointing double angle quotation mark special character.
not = Tooltip for the not sign special character.
reg = Tooltip for the registered sign special character.
macr = Tooltip for the macron special character.
deg = Tooltip for the degree sign special character.
sup2 = Tooltip for the superscript two special character.
sup3 = Tooltip for the superscript three special character.
acute = Tooltip for the acute accent special character.
micro = Tooltip for the micro sign special character.
para = Tooltip for the pilcrow sign special character.
middot = Tooltip for the middle dot special character.
cedil = Tooltip for the cedilla special character.
sup1 = Tooltip for the superscript one special character.
ordm = Tooltip for the masculine ordinal indicator special character.
raquo = Tooltip for the right-pointing double angle quotation mark special character.
frac14 = Tooltip for the vulgar fraction one quarter special character.
frac12 = Tooltip for the vulgar fraction one half special character.
frac34 = Tooltip for the vulgar fraction three quarters special character.
iquest = Tooltip for the inverted question mark special character.
Agrave = Tooltip for the Latin capital letter A with grave accent special character.
Aacute = Tooltip for the Latin capital letter A with acute accent special character.
Acirc = Tooltip for the Latin capital letter A with circumflex special character.
Atilde = Tooltip for the Latin capital letter A with tilde special character.
Auml = Tooltip for the Latin capital letter A with diaeresis special character.
Aring = Tooltip for the Latin capital letter A with ring above special character.
AElig = Tooltip for the Latin Capital letter Æ special character.
Ccedil = Tooltip for the Latin capital letter C with cedilla special character.
Egrave = Tooltip for the Latin capital letter E with grave accent special character.
Eacute = Tooltip for the Latin capital letter E with acute accent special character.
Ecirc = Tooltip for the Latin capital letter E with circumflex special character.
Euml = Tooltip for the Latin capital letter E with diaeresis special character.
Igrave = Tooltip for the Latin capital letter I with grave accent special character.
Iacute = Tooltip for the Latin capital letter I with acute accent special character.
Icirc = Tooltip for the Latin capital letter I with circumflex special character.
Iuml = Tooltip for the Latin capital letter I with diaeresis special character.
ETH = Tooltip for the Latin capital letter Eth special character.
Ntilde = Tooltip for the Latin capital letter N with tilde special character.
Ograve = Tooltip for the Latin capital letter O with grave accent special character.
Oacute = Tooltip for the Latin capital letter O with acute accent special character.
Ocirc = Tooltip for the Latin capital letter O with circumflex special character.
Otilde = Tooltip for the Latin capital letter O with tilde special character.
Ouml = Tooltip for the Latin capital letter O with diaeresis special character.
times = Tooltip for the multiplication sign special character.
Oslash = Tooltip for the Latin capital letter O with stroke special character.
Ugrave = Tooltip for the Latin capital letter U with grave accent special character.
Uacute = Tooltip for the Latin capital letter U with acute accent special character.
Ucirc = Tooltip for the Latin capital letter U with circumflex special character.
Uuml = Tooltip for the Latin capital letter U with diaeresis special character.
Yacute = Tooltip for the Latin capital letter Y with acute accent special character.
THORN = Tooltip for the Latin capital letter Thorn special character.
szlig = Tooltip for the Latin small letter sharp s special character.
agrave = Tooltip for the Latin small letter a with grave accent special character.
aacute = Tooltip for the Latin small letter a with acute accent special character.
acirc = Tooltip for the Latin small letter a with circumflex special character.
atilde = Tooltip for the Latin small letter a with tilde special character.
auml = Tooltip for the Latin small letter a with diaeresis special character.
aring = Tooltip for the Latin small letter a with ring above special character.
aelig = Tooltip for the Latin small letter æ special character.
ccedil = Tooltip for the Latin small letter c with cedilla special character.
egrave = Tooltip for the Latin small letter e with grave accent special character.
eacute = Tooltip for the Latin small letter e with acute accent special character.
ecirc = Tooltip for the Latin small letter e with circumflex special character.
euml = Tooltip for the Latin small letter e with diaeresis special character.
igrave = Tooltip for the Latin small letter i with grave accent special character.
iacute = Tooltip for the Latin small letter i with acute accent special character.
icirc = Tooltip for the Latin small letter i with circumflex special character.
iuml = Tooltip for the Latin small letter i with diaeresis special character.
eth = Tooltip for the Latin small letter eth special character.
ntilde = Tooltip for the Latin small letter n with tilde special character.
ograve = Tooltip for the Latin small letter o with grave accent special character.
oacute = Tooltip for the Latin small letter o with acute accent special character.
ocirc = Tooltip for the Latin small letter o with circumflex special character.
otilde = Tooltip for the Latin small letter o with tilde special character.
ouml = Tooltip for the Latin small letter o with diaeresis special character.
divide = Tooltip for the division sign special character.
oslash = Tooltip for the Latin small letter o with stroke special character.
ugrave = Tooltip for the Latin small letter u with grave accent special character.
uacute = Tooltip for the Latin small letter u with acute accent special character.
ucirc = Tooltip for the Latin small letter u with circumflex special character.
uuml = Tooltip for the Latin small letter u with diaeresis special character.
yacute = Tooltip for the Latin small letter y with acute accent special character.
thorn = Tooltip for the Latin small letter thorn special character.
yuml = Tooltip for the Latin small letter y with diaeresis special character.
OElig = Tooltip for the Latin capital ligature OE special character.
oelig = Tooltip for the Latin small ligature oe special character.
372 = Tooltip for the Latin capital letter W with circumflex special character.
374 = Tooltip for the Latin capital letter Y with circumflex special character.
373 = Tooltip for the Latin small letter w with circumflex special character.
375 = Tooltip for the Latin small letter y with circumflex special character.
sbquo = Tooltip for the single low-9 quotation mark special character.
8219 = Tooltip for the single high-reversed-9 quotation mark special character.
bdquo = Tooltip for the double low-9 quotation mark special character.
hellip = Tooltip for the horizontal ellipsis special character.
trade = Tooltip for the trade mark sign special character.
9658 = Tooltip for the black right-pointing pointer special character.
bull = Tooltip for the bullet special character.
rarr = Tooltip for the rightwards arrow special character.
rArr = Tooltip for the rightwards double arrow special character.
hArr = Tooltip for the left right double arrow special character.
diams = Tooltip for the black diamond suit special character.
asymp = Tooltip for the almost equal to special character.
